##################
#`````````````m``#
#``c````#``O`````#
#``````ewe```````#
#```````O`````m``#
#`m`````#````````#
#```m````````c```#
##################
DATA:
entrance
8
2
entrance
8
7
access
4
4