########
#``#`c`#
#``#```#
#``````###### 
#``O```m````# 
#``#````````# 
#```````m```# 
############# 
                    
DATA:
entrance
1
6
entrance
18
5
entrance
7
8
entrance
2
1
access
3
3