                    
      ########
      #`c````#
      #```#`c#
 ######``````###### 
 #```````O````````# 
 #``m````#````````# 
 #`````````````m``# 
 ################## 
                    
DATA:
entrance
1
7
entrance
18
7
access
7
7