####################
#``O```m``````O````#
#``````````````````#
#```````m`````O````#
#``````````````````#
#```c``````m```````#
#`````````c```O````#
####################
DATA:

entrance
20
4

entrance
20
6

entrance
6
7

entrance
6
2

entrance
9
7

entrance
1
3



access
3
3