#############
#```````````#
#```````````#
#```````````#
#``#``_``#``#
#```````````#
#```````````#
#############
DATA:
entrance
13
4
access
4
4